############
#          #
# PO X  ####
#          #
#######    #
# O ##     #
#   ##     #
#          #
#       X  #
#       #  #
############
